0 0 0 0 0 0 0 0 0 0 0 0 0 0 0 0 
0 0 0 0 0 0 0 0 0 0 0 0 0 0 0 0 
0 0 0 0 0 0 0 0 0 0 0 0 0 0 0 0 
0 0 1 2 2 2 2 3 0 0 0 0 2 0 0 0 
0 0 0 0 0 0 0 0 1 3 0 0 0 0 1 3 
0 0 0 0 0 0 0 0 0 0 0 0 0 2 4 4 
0 0 0 0 0 0 0 0 0 0 0 1 3 4 4 4
0 0 0 0 0 0 0 0 1 3 0 4 4 4 4 4
0 0 0 1 2 2 3 0 0 0 0 4 4 4 4 4 
1 2 3 0 0 0 0 0 1 2 3 4 4 4 4 4 
4 4 4 1 2 2 2 2 2 2 3 4 4 4 4 4
4 4 4 4 4 4 4 4 4 4 4 4 4 4 4 4