0 0 0 0 0 0 0 0 0 0 0 0 0 0 0 0
0 0 0 0 0 0 0 0 0 0 0 0 0 0 0 0 
0 0 0 0 0 0 0 0 0 0 0 0 0 0 0 0
0 0 0 0 1 2 2 3 0 0 0 0 0 0 0 0
0 0 2 0 0 0 0 0 0 2 0 0 0 0 0 0
1 0 0 0 0 0 0 0 0 0 0 0 0 0 0 0
2 2 3 0 0 0 0 0 0 0 0 0 0 0 0 0 
0 0 0 0 2 0 0 0 2 0 2 0 0 0 0 0
0 0 0 1 4 3 0 0 0 0 0 0 0 0 0 0
1 3 0 0 0 0 0 0 0 0 0 1 2 2 2 3
4 4 4 4 4 4 4 4 4 4 4 4 4 4 4 4
4 4 4 4 4 4 4 4 4 4 4 4 4 4 4 4